0 1 0 1 0 1 0 1 0 1 0 1
1 0 1 0 1 0 6 0 1 0 1 0
0 1 0 1 0 1 0 1 0 1 0 1
1 0 1 0 1 0 1 0 1 0 1 0
0 1 0 1 0 11 0 1 0 1 0 1
1 0 1 0 5 0 5 0 1 0 1 0
0 1 0 1 0 12 0 1 0 1 0 1
1 0 1 0 1 0 1 0 1 0 1 0
0 1 0 1 0 1 0 1 0 1 0 1
1 0 1 0 1 0 6 0 1 0 1 0
0 1 0 1 0 1 0 1 0 1 0 1
